                                                                                                                                                      
                                                                                                                                                         
                                                                                                                                                                                                                                                                                                                                                   
   #######                                                              #######                                                                    
   #.....##                                                           ###.....#######                                                 
   #......###                                                         #.............####                   #######                                
   #........#######                                                   #................##########      #####.....###                         
   ##.............#                                                   ###.......................########...........####                           
    ###...........#              ######                                 ###...........................................#####                           
      ###....######            ###....####                                ########........................................##                       
        #.....#                #.........##                                      ##........................................#                   
        ##....##               #..........###                                     #........................................#                    
         ###...#               ##...........#                                   ###.......................................##                
           #..##                ###.........####                            #####............#######..................#####             
           #..#                   ##...........######                ########.............####     #####........#######                              
           #..##                   ########.........#          #######................#####             ##########                          
           #...####                       #####...###        ###.................######                                                
           ##.....######                      ##..#      ####..................###                                                  
            ##.........#############           #..#    ###.....................#                                           
             ##....................#####     ###..######.......................###                                        
              #####....................#######...................................####                                   
                  #####.............................................................##                             
                      ####...........................................................##                                  
                         ##...........................................................#                                
                          #...........................................................#                               
                          #...........................................................#                              
                         ##..........................................................##                               
                        ##.........................................................###                          
                    #####.........................................................##                             
               ######...........................................................###                     
             ###....................######.................................######                         
            ##...................###############.......................#####                             
            #..................###################....................##                                
            #..................#######################...............##                               
            #..................#######################...............#                                
            ##..................########################.............#                                 
             ##..................≈≈###############...................#                                
              #...................≈≈≈≈≈≈##########...................##                        
              #.....................≈≈≈≈≈≈≈≈#####.....................###                        
             ##.....................≈≈≈≈≈≈≈≈≈≈#####.....................###                         
             #.......................≈≈≈≈≈≈≈≈≈###.........................###                              
             #..........................≈≈≈≈≈###............................###     
             #................................................................##     
             ###...............................................................#    
               ###............................................................##     
                 #######.....................................................##         
                       ###################.................................###    
                                        ###################################    
                                                                                                                
                                                                                                                       
                                                                                                                    